R 1280    720
NO  ./textures/bloodwal1.xpm
SO ./textures/bloodwal2.xpm
EA ./textures/bloodwal3.png
WE ./textures/bloodwal5.png

S ./textures/dragon.png
F ./textures/floor.xpm
C ./textures/ceiling.xpm

11111111111111111111111111111
11111111100011111111000000001
11010000000000000000000210001
11000000001100000111111110001
11000011111110000011110000001
11000011111112101211110000001
11000011111111111110000001111
11110111111111111011100001111
10010001111111100010000001111
10010001111111100000110000001
11010001111111000011111110001
10010001111111000011111111001
10110001111111000011111111001
10011001111111000011110000001
10000001111111101111110000001
11110001111110000111110010001
11110001111111110111110011001
10000001100000010111110001001
11100001101110010111110001001
11110001101110010111110011101
10010001101110010111110011101
10010001101110110111110000001
10000001101110100011110000001
10000011101110101111110100001
10000011101110000011110110001
10001111100111110011110011001
10000111110110010011110011101
10000011110110110011110000001
10000001110110000011110000001
10000001110110000011110000001
10011111110111111111100001111
10000001110110000011110000001
11111101110110000011110000011
10000001110110000011110000011
10111111110000111111111111111
100000011111101
100000002111101
10000000110000111111111111111
10000000000000000010000001111
11111111110000000011000000001
11111111110000011111000000001
10000000000000000011000000111
10000000000100011000000111111
10000001000100011000111111111
11000011112100001000000000211
11000000011100000000000111111
11000000000000010000000000001111111111111111111111111111111111111111111111111
110011100000000101111000000000111000000000000000001210000000000      00000011
111011100000001101011000000000011011111111000000001010120000000      00011011
110010000000001001111100000000001210001110000000101000101000000      00001111
110111000000011200011111000000000100000010000000101021111100000      010100W1
110121100000111111111111100000000000000000000000101111111111110      10000011
110000000000000000000000000011111111111111111111100000000000000      11111111
11111111111111111111111111111111111111111111111111111111111111111111111111111